//MAP CONVERTED BY dmm2tgm.py THIS HEADER COMMENT PREVENTS RECONVERSION, DO NOT REMOVE
"aa" = (
/turf/environment/space,
/area/space)
"ab" = (
/obj/structure/flora/ausbushes/sparsegrass,
/turf/simulated/floor{
	icon_state = "white"
	},
/area/space)
"ac" = (
/obj/structure/grille,
/obj/structure/window/reinforced{
	dir = 5
	},
/turf/simulated/floor/plating,
/area/space)
"ad" = (
/turf/simulated/shuttle/wall{
	dir = 8;
	icon_state = "diagonalWall3"
	},
/area/space)
"ae" = (
/obj/effect/decal/cleanable/dirt,
/obj/item/clothing/mask/gas/poltergeist,
/obj/machinery/atmospherics/components/unary/vent_pump/on,
/turf/simulated/floor{
	icon_state = "white"
	},
/area/space)
"af" = (
/obj/structure/table/glass,
/obj/item/weapon/storage/firstaid/toxin,
/obj/item/weapon/reagent_containers/hypospray,
/turf/simulated/floor{
	icon_state = "white"
	},
/area/space)
"ag" = (
/obj/structure/flora/ausbushes/sparsegrass,
/turf/simulated/floor,
/area/space)
"ah" = (
/obj/structure/window/reinforced{
	dir = 4
	},
/turf/simulated/floor/grass,
/area/space)
"ai" = (
/obj/structure/flora/ausbushes/sparsegrass,
/obj/effect/decal/cleanable/dirt,
/turf/simulated/floor{
	icon_state = "dark"
	},
/area/space)
"aj" = (
/obj/structure/flora/ausbushes/stalkybush,
/obj/machinery/atmospherics/pipe/simple/hidden/scrubbers,
/turf/simulated/floor{
	icon_state = "dark"
	},
/area/space)
"ak" = (
/obj/structure/computerframe{
	dir = 8
	},
/turf/simulated/floor{
	icon_state = "dark"
	},
/area/space)
"al" = (
/obj/item/seeds/ambrosiadeusseed,
/obj/item/seeds/ambrosiadeusseed,
/obj/item/seeds/ambrosiadeusseed,
/obj/item/seeds/ambrosiavulgarisseed,
/obj/item/seeds/ambrosiavulgarisseed,
/obj/item/seeds/walkingmushroommycelium,
/obj/structure/closet/crate,
/obj/item/seeds/vale,
/obj/item/seeds/surik,
/turf/simulated/floor{
	icon_state = "white"
	},
/area/space)
"am" = (
/obj/effect/decal/cleanable/dirt,
/obj/item/weapon/reagent_containers/spray/plantbgone,
/turf/simulated/floor{
	icon_state = "white"
	},
/area/space)
"an" = (
/turf/simulated/floor/grass,
/area/space)
"ao" = (
/obj/item/weapon/reagent_containers/pill/methylphenidate,
/turf/simulated/floor{
	icon_state = "white"
	},
/area/space)
"ap" = (
/obj/structure/flora/ausbushes/brflowers,
/turf/simulated/floor/grass,
/area/space)
"aq" = (
/obj/structure/computerframe{
	dir = 4
	},
/turf/simulated/floor{
	icon_state = "dark"
	},
/area/space)
"ar" = (
/obj/structure/window/reinforced{
	dir = 1
	},
/obj/structure/flora/ausbushes/sunnybush,
/turf/simulated/floor/grass,
/area/space)
"as" = (
/obj/structure/flora/ausbushes/stalkybush,
/turf/simulated/floor{
	icon_state = "white"
	},
/area/space)
"at" = (
/obj/structure/window/reinforced{
	dir = 1
	},
/obj/structure/flora/ausbushes/lavendergrass,
/turf/simulated/floor/grass,
/area/space)
"au" = (
/turf/simulated/shuttle/wall{
	icon_state = "wall3"
	},
/area/space)
"av" = (
/obj/structure/flora/junglebush/b,
/turf/simulated/floor/grass,
/area/space)
"aw" = (
/obj/machinery/hydroponics/constructable,
/obj/item/weapon/reagent_containers/food/snacks/grown/ambrosiavulgaris,
/turf/simulated/floor{
	icon_state = "white"
	},
/area/space)
"ax" = (
/obj/structure/window/reinforced{
	dir = 1
	},
/obj/structure/flora/junglebush,
/turf/simulated/floor/grass,
/area/space)
"ay" = (
/obj/item/weapon/reagent_containers/pill/LSD{
	pixel_x = 7;
	pixel_y = 9
	},
/obj/item/weapon/reagent_containers/pill/LSD{
	pixel_y = 5
	},
/obj/item/weapon/reagent_containers/pill/LSD{
	pixel_x = 4;
	pixel_y = -3
	},
/turf/simulated/floor{
	icon_state = "white"
	},
/area/space)
"az" = (
/obj/structure/window/reinforced{
	dir = 1
	},
/obj/structure/flora/bush,
/turf/simulated/floor/grass,
/area/space)
"aA" = (
/obj/structure/table/glass,
/obj/item/clothing/head/cakehat,
/turf/simulated/floor{
	icon_state = "white"
	},
/area/space)
"aB" = (
/turf/simulated/shuttle/wall{
	dir = 1;
	icon_state = "diagonalWall3"
	},
/area/space)
"aC" = (
/obj/structure/window/reinforced{
	dir = 8
	},
/obj/structure/flora/ausbushes/sparsegrass,
/turf/simulated/floor/grass,
/area/space)
"aD" = (
/obj/structure/flora/ausbushes/lavendergrass,
/turf/simulated/floor,
/area/space)
"aE" = (
/obj/structure/window/reinforced{
	dir = 4
	},
/obj/structure/flora/ausbushes/lavendergrass,
/turf/simulated/floor/grass,
/area/space)
"aF" = (
/obj/structure/window/reinforced{
	dir = 8
	},
/obj/structure/flora/ausbushes/lavendergrass,
/obj/structure/flora/junglebush/large,
/turf/simulated/floor/grass,
/area/space)
"aG" = (
/obj/structure/window/reinforced{
	dir = 4
	},
/obj/structure/flora/ausbushes/sunnybush,
/obj/effect/decal/cleanable/dirt,
/turf/simulated/floor/grass,
/area/space)
"aH" = (
/obj/structure/computerframe,
/turf/simulated/floor{
	icon_state = "dark"
	},
/area/space)
"aI" = (
/obj/structure/computerframe{
	anchored = 1
	},
/turf/simulated/floor{
	icon_state = "dark"
	},
/area/space)
"aJ" = (
/obj/structure/table/glass,
/obj/item/weapon/reagent_containers/pill/happy{
	pixel_x = 7;
	pixel_y = 5
	},
/obj/item/weapon/reagent_containers/pill/happy,
/obj/item/weapon/storage/pill_bottle/happy{
	pixel_x = -6;
	pixel_y = 8
	},
/obj/item/weapon/storage/pill_bottle/citalopram,
/obj/item/weapon/reagent_containers/syringe/antitoxin,
/obj/item/weapon/disk/research_points,
/turf/simulated/floor{
	icon_state = "white"
	},
/area/space)
"aK" = (
/obj/effect/decal/cleanable/dirt,
/turf/simulated/floor/grass,
/area/space)
"aL" = (
/obj/structure/flora/ausbushes/lavendergrass,
/turf/simulated/floor/grass,
/area/space)
"aM" = (
/obj/item/weapon/hatchet,
/turf/simulated/floor/grass,
/area/space)
"aN" = (
/obj/effect/decal/cleanable/dirt,
/turf/simulated/floor,
/area/space)
"aO" = (
/obj/structure/flora/ausbushes/reedbush,
/turf/simulated/floor/grass,
/area/space)
"aP" = (
/obj/effect/decal/cleanable/dirt,
/turf/simulated/floor{
	icon_state = "dark"
	},
/area/space)
"aQ" = (
/obj/structure/table/glass,
/obj/item/weapon/storage/pill_bottle/zoom{
	pixel_x = -4
	},
/obj/item/weapon/storage/pill_bottle/paroxetine{
	pixel_x = 3;
	pixel_y = 8
	},
/obj/item/weapon/storage/pill_bottle/citalopram{
	pixel_x = 8;
	pixel_y = -3
	},
/obj/item/weapon/reagent_containers/pill/LSD{
	pixel_x = -7;
	pixel_y = 10
	},
/obj/item/weapon/reagent_containers/pill/methylphenidate,
/turf/simulated/floor/grass,
/area/space)
"aR" = (
/obj/item/weapon/reagent_containers/pill/paracetamol{
	pixel_x = 12;
	pixel_y = 6
	},
/obj/item/weapon/spacecash/c500{
	pixel_x = -2;
	pixel_y = -7
	},
/obj/item/weapon/spacecash/c1000{
	pixel_x = 11;
	pixel_y = 5
	},
/obj/item/weapon/spacecash/c1000,
/obj/item/weapon/spacecash/c200{
	pixel_y = 9
	},
/obj/item/weapon/spacecash/c500{
	pixel_x = -12;
	pixel_y = 6
	},
/obj/effect/decal/cleanable/vomit{
	icon_state = "vomittox_2"
	},
/obj/effect/decal/remains/human,
/obj/item/clothing/suit/storage/labcoat/mad,
/turf/simulated/floor{
	icon_state = "white"
	},
/area/space)
"aS" = (
/obj/structure/flora/ausbushes/sparsegrass,
/turf/simulated/floor/grass,
/area/space)
"aT" = (
/obj/item/weapon/pestspray,
/turf/simulated/floor{
	icon_state = "white"
	},
/area/space)
"aU" = (
/obj/structure/flora/ausbushes/grassybush,
/turf/simulated/floor/grass,
/area/space)
"aV" = (
/obj/structure/flora/ausbushes/stalkybush,
/turf/simulated/floor/grass,
/area/space)
"aW" = (
/obj/structure/flora/ausbushes/sparsegrass,
/turf/simulated/floor{
	icon_state = "dark"
	},
/area/space)
"aX" = (
/obj/structure/flora/ausbushes/lavendergrass,
/obj/machinery/atmospherics/components/unary/vent_scrubber/on,
/turf/simulated/floor{
	icon_state = "dark"
	},
/area/space)
"aY" = (
/obj/machinery/constructable_frame/machine_frame,
/turf/simulated/floor{
	icon_state = "dark"
	},
/area/space)
"aZ" = (
/obj/machinery/hydroponics/constructable,
/obj/item/weapon/reagent_containers/food/snacks/grown/ambrosiadeus,
/turf/simulated/floor{
	icon_state = "white"
	},
/area/space)
"ba" = (
/obj/structure/window/reinforced{
	dir = 1
	},
/obj/structure/flora/ausbushes/sparsegrass,
/turf/simulated/floor/grass,
/area/space)
"bb" = (
/obj/effect/overlay/palmtree_l,
/turf/simulated/floor/grass,
/area/space)
"bc" = (
/turf/simulated/floor,
/area/space)
"bd" = (
/obj/structure/flora/junglebush/large,
/turf/simulated/floor/grass,
/area/space)
"be" = (
/obj/structure/flora/ausbushes/lavendergrass,
/obj/machinery/atmospherics/pipe/simple/hidden/scrubbers{
	dir = 4
	},
/turf/simulated/floor/grass,
/area/space)
"bf" = (
/obj/structure/window/reinforced,
/obj/structure/flora/bush,
/turf/simulated/floor/grass,
/area/space)
"bg" = (
/obj/structure/window/reinforced,
/obj/structure/flora/ausbushes/sparsegrass,
/turf/simulated/floor/grass,
/area/space)
"bh" = (
/obj/structure/window/reinforced,
/obj/structure/flora/ausbushes/sunnybush,
/obj/effect/decal/cleanable/dirt,
/turf/simulated/floor/grass,
/area/space)
"bi" = (
/obj/machinery/atmospherics/pipe/simple/hidden/supply{
	dir = 8
	},
/turf/simulated/floor,
/area/space)
"bj" = (
/obj/effect/overlay/palmtree_r,
/turf/simulated/floor/grass,
/area/space)
"bk" = (
/obj/structure/window/reinforced,
/obj/structure/flora/ausbushes/lavendergrass,
/turf/simulated/floor/grass,
/area/space)
"bl" = (
/obj/structure/window/reinforced,
/turf/simulated/floor/grass,
/area/space)
"bm" = (
/obj/machinery/chem_dispenser,
/turf/simulated/floor{
	icon_state = "white"
	},
/area/space)
"bn" = (
/obj/item/clothing/mask/gas/poltergeist,
/turf/simulated/floor{
	icon_state = "white"
	},
/area/space)
"bo" = (
/obj/structure/table/glass,
/obj/machinery/kitchen_machine/microwave,
/turf/simulated/floor{
	icon_state = "white"
	},
/area/space)
"bp" = (
/obj/structure/window/reinforced{
	dir = 8
	},
/obj/structure/flora/junglebush/large,
/turf/simulated/floor/grass,
/area/space)
"bq" = (
/obj/structure/flora/junglebush,
/turf/simulated/floor/grass,
/area/space)
"br" = (
/obj/structure/window/reinforced{
	dir = 4
	},
/obj/structure/flora/ausbushes/stalkybush,
/turf/simulated/floor/grass,
/area/space)
"bs" = (
/obj/item/weapon/storage/firstaid/regular,
/obj/structure/table/glass,
/turf/simulated/floor{
	icon_state = "white"
	},
/area/space)
"bt" = (
/obj/item/weapon/shard{
	icon_state = "medium"
	},
/turf/simulated/floor{
	icon_state = "white"
	},
/area/space)
"bu" = (
/turf/simulated/shuttle/wall{
	icon_state = "diagonalWall3"
	},
/area/space)
"bv" = (
/obj/machinery/chem_master,
/turf/simulated/floor{
	icon_state = "white"
	},
/area/space)
"bw" = (
/obj/effect/decal/cleanable/dirt,
/turf/simulated/floor{
	icon_state = "white"
	},
/area/space)
"bx" = (
/turf/simulated/floor{
	icon_state = "white"
	},
/area/space)
"by" = (
/obj/structure/window/reinforced{
	dir = 8
	},
/obj/structure/flora/ausbushes/reedbush,
/turf/simulated/floor/grass,
/area/space)
"bz" = (
/obj/structure/flora/junglebush/c,
/turf/simulated/floor/grass,
/area/space)
"bA" = (
/obj/structure/window/reinforced{
	dir = 4
	},
/obj/structure/flora/ausbushes/grassybush,
/turf/simulated/floor/grass,
/area/space)
"bB" = (
/obj/structure/flora/ausbushes/stalkybush,
/obj/structure/closet/emergency_wall{
	pixel_y = -32
	},
/turf/simulated/floor{
	icon_state = "white"
	},
/area/space)
"bC" = (
/turf/simulated/shuttle/wall{
	dir = 4;
	icon_state = "diagonalWall3"
	},
/area/space)
"bD" = (
/obj/structure/table/glass,
/obj/item/weapon/reagent_containers/food/snacks/dionaroast,
/obj/item/weapon/kitchenknife/plastic,
/turf/simulated/floor{
	icon_state = "white"
	},
/area/space)
"bE" = (
/obj/structure/table/glass,
/obj/item/weapon/storage/fancy/donut_box,
/turf/simulated/floor{
	icon_state = "white"
	},
/area/space)
"bF" = (
/obj/machinery/atmospherics/pipe/simple/hidden/supply,
/turf/simulated/floor/grass,
/area/space)
"bG" = (
/obj/structure/stool/bed/roller,
/obj/machinery/iv_drip,
/turf/simulated/floor{
	icon_state = "white"
	},
/area/space)
"bH" = (
/obj/structure/flora/ausbushes/lavendergrass,
/obj/machinery/atmospherics/pipe/simple/hidden/scrubbers,
/turf/simulated/floor/grass,
/area/space)
"bI" = (
/obj/structure/flora/junglebush/b,
/obj/machinery/atmospherics/pipe/simple/hidden/supply,
/turf/simulated/floor/grass,
/area/space)
"bJ" = (
/obj/structure/rack,
/obj/structure/window/reinforced{
	dir = 1
	},
/obj/structure/window/reinforced{
	dir = 8
	},
/obj/structure/window/reinforced,
/obj/item/weapon/shard,
/obj/item/stack/cable_coil/red,
/turf/simulated/floor,
/area/space)
"bK" = (
/obj/structure/flora/ausbushes/sparsegrass,
/obj/effect/decal/cleanable/dirt,
/turf/simulated/floor,
/area/space)
"bL" = (
/obj/structure/rack,
/obj/structure/window/reinforced{
	dir = 1
	},
/obj/structure/window/reinforced{
	dir = 4
	},
/obj/item/weapon/shard,
/obj/item/weapon/airlock_electronics,
/obj/item/stack/cable_coil/red,
/obj/structure/window/reinforced,
/turf/simulated/floor,
/area/space)
"bM" = (
/turf/simulated/floor{
	icon_state = "dark"
	},
/area/space)
"bN" = (
/obj/structure/sign/warning/vacuum/external{
	pixel_y = -30
	},
/turf/simulated/floor,
/area/space)
"bO" = (
/obj/structure/flora/ausbushes/sparsegrass,
/obj/machinery/atmospherics/pipe/simple/hidden/scrubbers{
	dir = 6
	},
/obj/machinery/atmospherics/pipe/simple/hidden/supply{
	dir = 5
	},
/turf/simulated/floor,
/area/space)
"bP" = (
/obj/structure/flora/ausbushes/lavendergrass,
/obj/machinery/atmospherics/pipe/simple/hidden/scrubbers{
	dir = 4
	},
/obj/machinery/atmospherics/pipe/simple/hidden/supply{
	dir = 8
	},
/turf/simulated/floor,
/area/space)
"bQ" = (
/obj/effect/decal/cleanable/dirt,
/obj/machinery/atmospherics/pipe/manifold/hidden/supply{
	dir = 1
	},
/turf/simulated/floor,
/area/space)
"bR" = (
/obj/structure/flora/ausbushes/ywflowers,
/obj/machinery/atmospherics/pipe/simple/hidden/scrubbers{
	dir = 4
	},
/obj/machinery/atmospherics/pipe/simple/hidden/supply{
	dir = 8
	},
/turf/simulated/floor,
/area/space)
"bS" = (
/obj/effect/decal/cleanable/dirt,
/obj/machinery/atmospherics/pipe/simple/hidden/scrubbers{
	dir = 4
	},
/turf/simulated/floor,
/area/space)
"bT" = (
/obj/structure/flora/ausbushes/sparsegrass,
/obj/machinery/atmospherics/pipe/simple/hidden/scrubbers{
	dir = 9
	},
/obj/machinery/atmospherics/pipe/simple/hidden/supply{
	dir = 10
	},
/turf/simulated/floor,
/area/space)
"bU" = (
/obj/machinery/atmospherics/pipe/simple/hidden/scrubbers,
/turf/simulated/floor/grass,
/area/space)
"bV" = (
/obj/structure/flora/ausbushes/stalkybush,
/obj/machinery/atmospherics/pipe/simple/hidden/scrubbers,
/turf/simulated/floor,
/area/space)
"bW" = (
/obj/effect/decal/cleanable/dirt,
/obj/machinery/atmospherics/pipe/simple/hidden/supply,
/turf/simulated/floor/grass,
/area/space)
"bX" = (
/obj/structure/flora/ausbushes/sparsegrass,
/obj/machinery/atmospherics/components/unary/vent_scrubber/on{
	dir = 1
	},
/turf/simulated/floor/grass,
/area/space)
"bY" = (
/obj/effect/decal/cleanable/dirt,
/obj/machinery/atmospherics/pipe/simple/hidden/scrubbers,
/obj/machinery/atmospherics/pipe/simple/hidden/supply,
/turf/simulated/floor,
/area/space)
"bZ" = (
/obj/structure/flora/ausbushes/sparsegrass,
/obj/machinery/atmospherics/components/unary/vent_pump/on{
	dir = 1
	},
/turf/simulated/floor{
	icon_state = "white"
	},
/area/space)
"ca" = (
/obj/structure/flora/ausbushes/lavendergrass,
/obj/machinery/atmospherics/pipe/simple/hidden/scrubbers,
/obj/machinery/atmospherics/pipe/simple/hidden/supply,
/obj/machinery/access_button{
	command = "cycle_interior";
	frequency = 1380;
	master_tag = "agrosphere_airlock";
	name = "interior access button";
	pixel_x = 20;
	pixel_y = -20
	},
/turf/simulated/floor/grass,
/area/space)
"cb" = (
/obj/machinery/door/airlock/external{
	frequency = 1380;
	id_tag = "agrosphere_inner";
	locked = 1;
	name = "Agrosphere External Access"
	},
/obj/machinery/atmospherics/pipe/simple/hidden/scrubbers,
/turf/simulated/floor{
	icon_state = "dark"
	},
/area/space)
"cc" = (
/obj/structure/closet/crate,
/obj/item/stack/sheet/mineral/phoron{
	amount = 25
	},
/turf/simulated/floor,
/area/space)
"cd" = (
/obj/machinery/power/port_gen/pacman,
/turf/simulated/floor,
/area/space)
"ce" = (
/obj/effect/decal/cleanable/dirt,
/obj/machinery/atmospherics/pipe/simple/hidden/scrubbers,
/turf/simulated/floor,
/area/space)
"cf" = (
/obj/effect/decal/cleanable/dirt,
/obj/machinery/portable_atmospherics/canister/air,
/obj/machinery/atmospherics/components/unary/portables_connector,
/turf/simulated/floor,
/area/space)
"cg" = (
/obj/machinery/atmospherics/pipe/simple/hidden/supply,
/turf/simulated/floor,
/area/space)
"ch" = (
/obj/machinery/atmospherics/components/unary/vent_pump/high_volume{
	dir = 1;
	frequency = 1380;
	id_tag = "agrosphere_pump";
	name = "Agrosphere Large Air Vent"
	},
/turf/simulated/floor,
/area/space)
"ci" = (
/obj/effect/decal/cleanable/dirt,
/obj/machinery/embedded_controller/radio/airlock_controller{
	frequency = 1380;
	id_tag = "agrosphere_airlock";
	pixel_x = 25;
	tag_airpump = "agrosphere_pump";
	tag_chamber_sensor = "agrosphere_sensor";
	tag_exterior_door = "agrosphere_outer";
	tag_interior_door = "agrosphere_inner"
	},
/obj/machinery/airlock_sensor{
	frequency = 1380;
	id_tag = "agrosphere_sensor";
	pixel_x = 25;
	pixel_y = 12
	},
/turf/simulated/floor,
/area/space)
"cj" = (
/obj/machinery/door/airlock/external{
	frequency = 1380;
	id_tag = "agrosphere_outer";
	locked = 1
	},
/turf/simulated/floor{
	icon_state = "dark"
	},
/area/space)
"ck" = (
/obj/machinery/access_button{
	command = "cycle_exterior";
	frequency = 1380;
	master_tag = "agrosphere_airlock";
	name = "exterior access button";
	pixel_x = 20;
	pixel_y = 20
	},
/turf/space,
/area/space)
"cl" = (
/turf/space,
/area/space)
"fK" = (
/obj/structure/window/reinforced{
	dir = 8
	},
/obj/structure/flora/junglebush,
/turf/simulated/floor/grass,
/area/space)
"OZ" = (
/obj/structure/flora/ausbushes/sunnybush,
/turf/simulated/floor/grass,
/area/space)

(1,1,1) = {"
aa
aa
aa
aa
aa
aa
aa
aa
aa
aa
aa
aa
aa
aa
aa
aa
aa
aa
aa
cl
aa
aa
aa
aa
aa
cl
aa
aa
aa
aa
aa
aa
aa
aa
"}
(2,1,1) = {"
aa
aa
aa
aa
aa
aa
aa
aa
aa
aa
aa
aa
aa
aa
aa
ad
ac
ac
ac
bu
cl
cl
cl
cl
cl
cl
aa
aa
aa
aa
aa
aa
aa
aa
"}
(3,1,1) = {"
aa
aa
aa
aa
aa
aa
aa
aa
aa
aa
aa
aa
aa
ad
ac
au
ar
aD
bf
au
au
bu
cl
cl
cl
cl
aa
aa
aa
aa
aa
aa
aa
aa
"}
(4,1,1) = {"
aa
aa
aa
aa
aa
aa
aa
aa
aa
aa
aa
ad
au
au
aZ
al
at
bc
bg
bm
bv
au
au
bu
cl
cl
cl
aa
aa
aa
aa
aa
aa
aa
"}
(5,1,1) = {"
aa
aa
aa
aa
aa
aa
aa
aa
aa
aa
aa
au
aA
aQ
ab
am
aS
aN
aS
bn
ab
bD
au
au
cl
cl
cl
cl
aa
aa
aa
aa
aa
aa
"}
(6,1,1) = {"
aa
aa
aa
aa
aa
aa
aa
aa
aa
aa
ad
au
aJ
aR
ae
bF
bI
bO
bU
bX
bw
bE
au
au
bu
cl
cl
cl
cl
aa
aa
aa
aa
aa
"}
(7,1,1) = {"
cl
cl
cl
cl
cl
cl
cl
cl
cl
cl
au
aw
ay
aS
as
ao
ba
be
bh
bo
bx
au
au
bJ
au
cl
cl
cl
cl
cl
cl
aa
aa
aa
"}
(8,1,1) = {"
aa
cl
cl
cl
cl
cl
cl
cl
cl
ad
au
aw
aK
aT
af
au
bb
bi
aU
bp
by
au
cc
aN
au
bu
cl
cl
cl
cl
cl
cl
cl
cl
"}
(9,1,1) = {"
aa
cl
cl
cl
cl
cl
cl
cl
cl
ac
aC
aF
aL
aU
fK
aL
aV
bP
aS
bq
bz
au
cd
bK
bN
au
cl
cl
cl
cl
cl
cl
cl
cl
"}
(10,1,1) = {"
aa
cl
cl
cl
cl
cl
cl
cl
cl
ac
aD
aN
aM
aN
ag
aN
bc
bQ
bV
bY
ca
cb
ce
cg
bc
cj
ck
cl
cl
cl
cl
cl
cl
cl
"}
(11,1,1) = {"
aa
cl
cl
cl
cl
cl
cl
cl
cl
ac
aE
aG
aO
aV
ah
ap
bd
bR
an
aS
av
au
an
bc
ci
au
cl
cl
cl
cl
cl
cl
cl
cl
"}
(12,1,1) = {"
aa
cl
cl
cl
cl
cl
cl
cl
cl
aB
au
aH
aL
aW
aY
au
aV
bi
bj
br
bA
au
cf
ch
au
bC
cl
cl
cl
cl
cl
cl
cl
cl
"}
(13,1,1) = {"
cl
cl
cl
cl
cl
cl
cl
cl
cl
cl
au
aI
aP
aP
ai
aq
ba
bS
bk
bs
bt
au
au
bL
au
cl
cl
cl
cl
cl
cl
aa
aa
aa
"}
(14,1,1) = {"
aa
aa
aa
aa
aa
aa
aa
aa
aa
aa
aB
au
aI
aX
aj
bH
an
bT
bW
bZ
bw
bG
au
au
bC
cl
cl
cl
cl
aa
aa
aa
aa
aa
"}
(15,1,1) = {"
aa
aa
aa
aa
aa
aa
aa
aa
aa
aa
aa
au
aY
bM
aP
aW
OZ
an
aL
an
bx
ab
au
au
cl
cl
cl
cl
aa
aa
aa
aa
aa
aa
"}
(16,1,1) = {"
aa
aa
aa
aa
aa
aa
aa
aa
aa
aa
aa
aB
au
au
ak
ak
ax
bc
bg
bt
bB
au
au
bC
cl
cl
cl
aa
aa
aa
aa
aa
aa
aa
"}
(17,1,1) = {"
aa
aa
aa
aa
aa
aa
aa
aa
aa
aa
aa
aa
aa
aB
ac
au
az
aD
bl
au
au
bC
cl
cl
cl
cl
aa
aa
aa
aa
aa
aa
aa
aa
"}
(18,1,1) = {"
aa
aa
aa
aa
aa
aa
aa
aa
aa
aa
aa
aa
aa
aa
aa
aB
ac
ac
ac
bC
cl
cl
cl
cl
cl
cl
aa
aa
aa
aa
aa
aa
aa
aa
"}
(19,1,1) = {"
aa
aa
aa
aa
aa
aa
aa
aa
aa
aa
aa
aa
aa
aa
aa
aa
aa
aa
aa
cl
aa
aa
aa
aa
aa
cl
aa
aa
aa
aa
aa
aa
aa
aa
"}
