//MAP CONVERTED BY dmm2tgm.py THIS HEADER COMMENT PREVENTS RECONVERSION, DO NOT REMOVE
"aa" = (
/turf/space,
/area/space)
"ab" = (
/obj/structure/flora/ausbushes/sparsegrass,
/turf/simulated/floor{
	icon_state = "white"
	},
/area/space)
"ac" = (
/obj/structure/grille,
/obj/structure/window/reinforced{
	dir = 5
	},
/turf/simulated/floor/plating,
/area/space)
"ad" = (
/turf/simulated/shuttle/wall{
	dir = 8;
	icon_state = "diagonalWall3"
	},
/area/space)
"ae" = (
/obj/effect/decal/cleanable/dirt,
/obj/item/clothing/mask/gas/poltergeist,
/turf/simulated/floor{
	icon_state = "white"
	},
/area/space)
"af" = (
/obj/structure/table/glass,
/obj/item/weapon/storage/firstaid/toxin,
/obj/item/weapon/reagent_containers/hypospray,
/turf/simulated/floor{
	icon_state = "white"
	},
/area/space)
"ag" = (
/obj/structure/flora/ausbushes/sparsegrass,
/turf/simulated/floor,
/area/space)
"ah" = (
/obj/structure/window/reinforced{
	dir = 4
	},
/turf/simulated/floor/grass,
/area/space)
"ai" = (
/obj/structure/flora/ausbushes/sparsegrass,
/obj/effect/decal/cleanable/dirt,
/turf/simulated/floor{
	icon_state = "dark"
	},
/area/space)
"aj" = (
/obj/structure/flora/ausbushes/stalkybush,
/turf/simulated/floor{
	icon_state = "dark"
	},
/area/space)
"ak" = (
/obj/structure/computerframe{
	dir = 8
	},
/turf/simulated/floor{
	icon_state = "dark"
	},
/area/space)
"al" = (
/obj/item/seeds/ambrosiadeusseed,
/obj/item/seeds/ambrosiadeusseed,
/obj/item/seeds/ambrosiadeusseed,
/obj/item/seeds/ambrosiavulgarisseed,
/obj/item/seeds/ambrosiavulgarisseed,
/obj/item/seeds/walkingmushroommycelium,
/obj/structure/closet/crate,
/obj/item/seeds/vale,
/obj/item/seeds/surik,
/turf/simulated/floor{
	icon_state = "white"
	},
/area/space)
"am" = (
/obj/effect/decal/cleanable/dirt,
/obj/item/weapon/reagent_containers/spray/plantbgone,
/turf/simulated/floor{
	icon_state = "white"
	},
/area/space)
"an" = (
/turf/simulated/floor/grass,
/area/space)
"ao" = (
/obj/item/weapon/reagent_containers/pill/methylphenidate,
/turf/simulated/floor{
	icon_state = "white"
	},
/area/space)
"ap" = (
/obj/structure/flora/ausbushes/brflowers,
/turf/simulated/floor/grass,
/area/space)
"aq" = (
/obj/structure/computerframe{
	dir = 4
	},
/turf/simulated/floor{
	icon_state = "dark"
	},
/area/space)
"ar" = (
/obj/structure/window/reinforced{
	dir = 1
	},
/obj/structure/flora/ausbushes/sunnybush,
/turf/simulated/floor/grass,
/area/space)
"as" = (
/obj/structure/flora/ausbushes/stalkybush,
/turf/simulated/floor{
	icon_state = "white"
	},
/area/space)
"at" = (
/obj/structure/window/reinforced{
	dir = 1
	},
/obj/structure/flora/ausbushes/lavendergrass,
/turf/simulated/floor/grass,
/area/space)
"au" = (
/turf/simulated/shuttle/wall{
	icon_state = "wall3"
	},
/area/space)
"av" = (
/obj/structure/flora/junglebush/b,
/turf/simulated/floor/grass,
/area/space)
"aw" = (
/obj/machinery/hydroponics/constructable,
/obj/item/weapon/reagent_containers/food/snacks/grown/ambrosiavulgaris,
/turf/simulated/floor{
	icon_state = "white"
	},
/area/space)
"ax" = (
/obj/structure/window/reinforced{
	dir = 1
	},
/obj/structure/flora/junglebush,
/turf/simulated/floor/grass,
/area/space)
"ay" = (
/obj/item/weapon/reagent_containers/pill/LSD{
	pixel_x = 7;
	pixel_y = 9
	},
/obj/item/weapon/reagent_containers/pill/LSD{
	pixel_y = 5
	},
/obj/item/weapon/reagent_containers/pill/LSD{
	pixel_x = 4;
	pixel_y = -3
	},
/turf/simulated/floor{
	icon_state = "white"
	},
/area/space)
"az" = (
/obj/structure/window/reinforced{
	dir = 1
	},
/obj/structure/flora/bush,
/turf/simulated/floor/grass,
/area/space)
"aA" = (
/turf/simulated/mineral,
/area/space)
"aB" = (
/turf/simulated/shuttle/wall{
	dir = 1;
	icon_state = "diagonalWall3"
	},
/area/space)
"aC" = (
/obj/structure/window/reinforced{
	dir = 8
	},
/obj/structure/flora/ausbushes/sparsegrass,
/turf/simulated/floor/grass,
/area/space)
"aD" = (
/obj/structure/flora/ausbushes/lavendergrass,
/turf/simulated/floor,
/area/space)
"aE" = (
/obj/structure/window/reinforced{
	dir = 4
	},
/obj/structure/flora/ausbushes/lavendergrass,
/turf/simulated/floor/grass,
/area/space)
"aF" = (
/obj/structure/window/reinforced{
	dir = 8
	},
/obj/structure/flora/ausbushes/lavendergrass,
/obj/structure/flora/junglebush/large,
/turf/simulated/floor/grass,
/area/space)
"aG" = (
/obj/structure/window/reinforced{
	dir = 4
	},
/obj/structure/flora/ausbushes/sunnybush,
/obj/effect/decal/cleanable/dirt,
/turf/simulated/floor/grass,
/area/space)
"aH" = (
/obj/structure/computerframe,
/turf/simulated/floor{
	icon_state = "dark"
	},
/area/space)
"aI" = (
/obj/structure/computerframe{
	anchored = 1
	},
/turf/simulated/floor{
	icon_state = "dark"
	},
/area/space)
"aJ" = (
/obj/structure/table/glass,
/obj/item/weapon/reagent_containers/pill/happy{
	pixel_x = 7;
	pixel_y = 5
	},
/obj/item/weapon/reagent_containers/pill/happy,
/obj/item/weapon/storage/pill_bottle/happy{
	pixel_x = -6;
	pixel_y = 8
	},
/obj/item/weapon/storage/pill_bottle/citalopram,
/obj/item/weapon/reagent_containers/syringe/antitoxin,
/obj/item/weapon/disk/research_points,
/turf/simulated/floor{
	icon_state = "white"
	},
/area/space)
"aK" = (
/obj/effect/decal/cleanable/dirt,
/turf/simulated/floor/grass,
/area/space)
"aL" = (
/obj/structure/flora/ausbushes/lavendergrass,
/turf/simulated/floor/grass,
/area/space)
"aM" = (
/obj/item/weapon/hatchet,
/turf/simulated/floor/grass,
/area/space)
"aN" = (
/obj/effect/decal/cleanable/dirt,
/turf/simulated/floor,
/area/space)
"aO" = (
/obj/structure/flora/ausbushes/reedbush,
/turf/simulated/floor/grass,
/area/space)
"aP" = (
/obj/effect/decal/cleanable/dirt,
/turf/simulated/floor{
	icon_state = "dark"
	},
/area/space)
"aQ" = (
/obj/structure/table/glass,
/obj/item/weapon/storage/pill_bottle/zoom{
	pixel_x = -4
	},
/obj/item/weapon/storage/pill_bottle/paroxetine{
	pixel_x = 3;
	pixel_y = 8
	},
/obj/item/weapon/storage/pill_bottle/citalopram{
	pixel_x = 8;
	pixel_y = -3
	},
/obj/item/weapon/reagent_containers/pill/LSD{
	pixel_x = -7;
	pixel_y = 10
	},
/obj/item/weapon/reagent_containers/pill/methylphenidate,
/turf/simulated/floor/grass,
/area/space)
"aR" = (
/obj/item/weapon/reagent_containers/pill/paracetamol{
	pixel_x = 12;
	pixel_y = 6
	},
/obj/item/weapon/spacecash/c500{
	pixel_x = -2;
	pixel_y = -7
	},
/obj/item/weapon/spacecash/c1000{
	pixel_x = 11;
	pixel_y = 5
	},
/obj/item/weapon/spacecash/c1000,
/obj/item/weapon/spacecash/c200{
	pixel_y = 9
	},
/obj/item/weapon/spacecash/c500{
	pixel_x = -12;
	pixel_y = 6
	},
/obj/effect/decal/cleanable/vomit{
	icon_state = "vomittox_2"
	},
/obj/effect/decal/remains/human,
/obj/item/clothing/suit/storage/labcoat/mad,
/obj/item/clothing/head/cakehat,
/turf/simulated/floor{
	icon_state = "white"
	},
/area/space)
"aS" = (
/obj/structure/flora/ausbushes/sparsegrass,
/turf/simulated/floor/grass,
/area/space)
"aT" = (
/obj/item/weapon/pestspray,
/turf/simulated/floor{
	icon_state = "white"
	},
/area/space)
"aU" = (
/obj/structure/flora/ausbushes/grassybush,
/turf/simulated/floor/grass,
/area/space)
"aV" = (
/obj/structure/flora/ausbushes/stalkybush,
/turf/simulated/floor/grass,
/area/space)
"aW" = (
/obj/structure/flora/ausbushes/sparsegrass,
/turf/simulated/floor{
	icon_state = "dark"
	},
/area/space)
"aX" = (
/obj/structure/flora/ausbushes/lavendergrass,
/turf/simulated/floor{
	icon_state = "dark"
	},
/area/space)
"aY" = (
/obj/machinery/constructable_frame/machine_frame,
/turf/simulated/floor{
	icon_state = "dark"
	},
/area/space)
"aZ" = (
/obj/machinery/hydroponics/constructable,
/obj/item/weapon/reagent_containers/food/snacks/grown/ambrosiadeus,
/turf/simulated/floor{
	icon_state = "white"
	},
/area/space)
"ba" = (
/obj/structure/window/reinforced{
	dir = 1
	},
/obj/structure/flora/ausbushes/sparsegrass,
/turf/simulated/floor/grass,
/area/space)
"bb" = (
/obj/effect/overlay/palmtree_l,
/turf/simulated/floor/grass,
/area/space)
"bc" = (
/turf/simulated/floor,
/area/space)
"bd" = (
/obj/structure/flora/junglebush/large,
/turf/simulated/floor/grass,
/area/space)
"be" = (
/obj/structure/flora/ausbushes/ywflowers,
/turf/simulated/floor,
/area/space)
"bf" = (
/obj/structure/window/reinforced,
/obj/structure/flora/bush,
/turf/simulated/floor/grass,
/area/space)
"bg" = (
/obj/structure/window/reinforced,
/obj/structure/flora/ausbushes/sparsegrass,
/turf/simulated/floor/grass,
/area/space)
"bh" = (
/obj/structure/window/reinforced,
/obj/structure/flora/ausbushes/sunnybush,
/obj/effect/decal/cleanable/dirt,
/turf/simulated/floor/grass,
/area/space)
"bi" = (
/obj/structure/flora/ausbushes/stalkybush,
/turf/simulated/floor,
/area/space)
"bj" = (
/obj/effect/overlay/palmtree_r,
/turf/simulated/floor/grass,
/area/space)
"bk" = (
/obj/structure/window/reinforced,
/obj/structure/flora/ausbushes/lavendergrass,
/turf/simulated/floor/grass,
/area/space)
"bl" = (
/obj/structure/window/reinforced,
/turf/simulated/floor/grass,
/area/space)
"bm" = (
/obj/machinery/chem_dispenser,
/turf/simulated/floor{
	icon_state = "white"
	},
/area/space)
"bn" = (
/obj/item/clothing/mask/gas/poltergeist,
/turf/simulated/floor{
	icon_state = "white"
	},
/area/space)
"bo" = (
/obj/structure/table/glass,
/obj/machinery/kitchen_machine/microwave,
/turf/simulated/floor{
	icon_state = "white"
	},
/area/space)
"bp" = (
/obj/structure/window/reinforced{
	dir = 8
	},
/obj/structure/flora/junglebush/large,
/turf/simulated/floor/grass,
/area/space)
"bq" = (
/obj/structure/flora/junglebush,
/turf/simulated/floor/grass,
/area/space)
"br" = (
/obj/structure/window/reinforced{
	dir = 4
	},
/obj/structure/flora/ausbushes/stalkybush,
/turf/simulated/floor/grass,
/area/space)
"bs" = (
/obj/item/weapon/storage/firstaid/regular,
/obj/structure/table/glass,
/turf/simulated/floor{
	icon_state = "white"
	},
/area/space)
"bt" = (
/obj/item/weapon/shard{
	icon_state = "medium"
	},
/turf/simulated/floor{
	icon_state = "white"
	},
/area/space)
"bu" = (
/turf/simulated/shuttle/wall{
	icon_state = "diagonalWall3"
	},
/area/space)
"bv" = (
/obj/machinery/chem_master,
/turf/simulated/floor{
	icon_state = "white"
	},
/area/space)
"bw" = (
/obj/effect/decal/cleanable/dirt,
/turf/simulated/floor{
	icon_state = "white"
	},
/area/space)
"bx" = (
/turf/simulated/floor{
	icon_state = "white"
	},
/area/space)
"by" = (
/obj/structure/window/reinforced{
	dir = 8
	},
/obj/structure/flora/ausbushes/reedbush,
/turf/simulated/floor/grass,
/area/space)
"bz" = (
/obj/structure/flora/junglebush/c,
/turf/simulated/floor/grass,
/area/space)
"bA" = (
/obj/structure/window/reinforced{
	dir = 4
	},
/obj/structure/flora/ausbushes/grassybush,
/turf/simulated/floor/grass,
/area/space)
"bB" = (
/obj/structure/flora/ausbushes/stalkybush,
/obj/structure/closet/emergency_wall{
	pixel_y = -32
	},
/turf/simulated/floor{
	icon_state = "white"
	},
/area/space)
"bC" = (
/turf/simulated/shuttle/wall{
	dir = 4;
	icon_state = "diagonalWall3"
	},
/area/space)
"bD" = (
/obj/structure/table/glass,
/obj/item/weapon/reagent_containers/food/snacks/dionaroast,
/obj/item/weapon/kitchenknife/plastic,
/turf/simulated/floor{
	icon_state = "white"
	},
/area/space)
"bE" = (
/obj/structure/table/glass,
/obj/item/weapon/storage/fancy/donut_box,
/turf/simulated/floor{
	icon_state = "white"
	},
/area/space)
"bF" = (
/obj/machinery/door/airlock/external,
/turf/simulated/floor{
	icon_state = "dark"
	},
/area/space)
"bG" = (
/obj/structure/stool/bed/roller,
/obj/machinery/iv_drip,
/turf/simulated/floor{
	icon_state = "white"
	},
/area/space)
"bH" = (
/obj/machinery/portable_atmospherics/canister/oxygen,
/turf/simulated/floor,
/area/space)
"bI" = (
/obj/effect/decal/cleanable/dirt,
/obj/item/clothing/mask/gas/poltergeist,
/obj/structure/rack,
/turf/simulated/floor,
/area/space)
"bJ" = (
/obj/structure/rack,
/obj/structure/window/reinforced{
	dir = 1
	},
/obj/structure/window/reinforced{
	dir = 8
	},
/obj/structure/window/reinforced,
/obj/item/weapon/shard,
/obj/item/stack/cable_coil/red,
/turf/simulated/floor,
/area/space)
"bK" = (
/obj/structure/flora/ausbushes/sparsegrass,
/obj/effect/decal/cleanable/dirt,
/turf/simulated/floor,
/area/space)
"bL" = (
/obj/structure/rack,
/obj/structure/window/reinforced{
	dir = 1
	},
/obj/structure/window/reinforced{
	dir = 4
	},
/obj/item/weapon/shard,
/obj/item/weapon/airlock_electronics,
/obj/item/stack/cable_coil/red,
/obj/structure/window/reinforced,
/turf/simulated/floor,
/area/space)
"bM" = (
/obj/structure/shuttle/engine/propulsion,
/turf/space,
/area/space)
"bN" = (
/obj/structure/sign/warning/vacuum/external{
	pixel_y = -30
	},
/turf/simulated/floor,
/area/space)
"bO" = (
/obj/effect/decal/cleanable/dirt,
/obj/structure/closet/emcloset/legacy,
/turf/simulated/floor,
/area/space)
"fK" = (
/obj/structure/window/reinforced{
	dir = 8
	},
/obj/structure/flora/junglebush,
/turf/simulated/floor/grass,
/area/space)
"OZ" = (
/obj/structure/flora/ausbushes/sunnybush,
/turf/simulated/floor/grass,
/area/space)

(1,1,1) = {"
aa
aa
aa
aa
aa
aa
aa
aa
aa
aA
aa
aa
aa
aa
aa
aa
aa
aa
aa
aa
aa
aa
aa
aa
aa
aA
aA
aa
aa
aa
aa
aa
aa
aa
"}
(2,1,1) = {"
aa
aa
aa
aa
aa
aA
aa
aa
aa
aa
aa
aa
aa
aa
ad
au
ac
ac
ac
au
bu
aa
aa
aa
aa
aa
aa
aa
aa
aa
aa
aa
aa
aa
"}
(3,1,1) = {"
aa
aa
aA
aa
aA
aA
aA
aa
aA
aa
aa
aa
ad
au
ac
au
ar
aD
bf
au
au
au
bu
aa
aa
aa
aA
aa
aA
aa
aa
aa
aa
aa
"}
(4,1,1) = {"
aa
aa
aa
aa
aA
aA
aa
aa
aa
aa
aa
ad
au
au
aZ
al
at
bc
bg
bm
bv
au
au
bu
aa
aa
aA
aa
aa
aa
aa
aa
aa
aa
"}
(5,1,1) = {"
aa
aa
aA
aa
aa
aa
aa
aa
aa
aa
ad
au
au
aQ
ab
am
aS
aN
aS
bn
ab
bD
au
au
bu
aa
aa
aa
aA
aa
aA
aa
aa
aa
"}
(6,1,1) = {"
aa
aA
aA
aa
aa
aA
aA
aa
aa
aa
au
au
aJ
aR
ae
an
av
ag
an
aS
bw
bE
au
au
bM
aa
aa
aa
aa
aa
aA
aa
aa
aa
"}
(7,1,1) = {"
aa
aA
aa
aa
aA
aA
aA
aa
aa
ad
au
aw
ay
aS
as
ao
ba
aL
bh
bo
bx
au
au
bJ
au
bu
aa
aA
aA
aa
aa
aa
aA
aa
"}
(8,1,1) = {"
aa
aa
aa
aa
aA
aA
aa
aa
aa
au
au
aw
aK
aT
af
au
bb
bc
aU
bp
by
au
bH
aN
au
au
aa
aA
aA
aa
aa
aa
aA
aa
"}
(9,1,1) = {"
aa
aa
aA
aa
aa
aA
aA
aA
aa
ac
aC
aF
aL
aU
fK
aL
aV
aD
aS
bq
bz
au
bc
bK
bN
au
aa
aA
aa
aa
aA
aa
aa
aa
"}
(10,1,1) = {"
aA
aa
aa
aa
aa
aa
aA
aa
aa
ac
aD
aN
aM
aN
ag
aN
bc
aN
bi
aN
aL
bF
aN
bc
bc
bF
aa
aa
aa
aa
aa
aA
aa
aa
"}
(11,1,1) = {"
aa
aa
aA
aA
aa
aa
aa
aa
aa
ac
aE
aG
aO
aV
ah
ap
bd
be
an
aS
av
au
an
bc
bO
au
aa
aa
aa
aa
aa
aa
aa
aa
"}
(12,1,1) = {"
aa
aa
aA
aA
aA
aa
aa
aa
aa
au
au
aH
aL
aW
aY
au
aV
bc
bj
br
bA
au
bI
bc
au
au
aa
aa
aA
aa
aa
aa
aa
aa
"}
(13,1,1) = {"
aA
aa
aa
aA
aA
aa
aA
aa
aa
aB
au
aI
aP
aP
ai
aq
ba
aN
bk
bs
bt
au
au
bL
au
bC
aa
aa
aa
aa
aA
aa
aa
aa
"}
(14,1,1) = {"
aa
aa
aa
aa
aa
aa
aA
aA
aa
aa
au
au
aI
aX
aj
aL
an
ag
aK
ab
bw
bG
au
au
bM
aa
aa
aa
aa
aa
aa
aa
aA
aa
"}
(15,1,1) = {"
aa
aa
aA
aa
aa
aa
aA
aA
aa
aa
aB
au
au
aY
aP
aW
OZ
an
aL
an
bx
ab
au
au
bC
aa
aa
aA
aa
aA
aA
aa
aa
aa
"}
(16,1,1) = {"
aa
aa
aa
aa
aa
aA
aA
aa
aa
aa
aa
aB
au
au
ak
ak
ax
bc
bg
bt
bB
au
au
bC
aa
aa
aa
aa
aa
aA
aa
aa
aa
aa
"}
(17,1,1) = {"
aa
aA
aa
aa
aa
aA
aA
aa
aa
aA
aa
aa
aB
au
ac
au
az
aD
bl
au
au
au
bC
aa
aa
aa
aA
aa
aa
aa
aa
aa
aa
aa
"}
(18,1,1) = {"
aa
aa
aa
aA
aa
aa
aa
aa
aa
aa
aa
aa
aa
aa
aB
au
ac
ac
ac
au
bC
aa
aa
aa
aa
aA
aA
aa
aa
aa
aA
aa
aa
aa
"}
(19,1,1) = {"
aa
aa
aa
aa
aa
aa
aa
aa
aA
aa
aa
aa
aa
aa
aa
aa
aa
aa
aa
aa
aa
aa
aa
aA
aa
aa
aa
aa
aa
aa
aa
aa
aa
aa
"}
