//MAP CONVERTED BY dmm2tgm.py THIS HEADER COMMENT PREVENTS RECONVERSION, DO NOT REMOVE
"bt" = (
/turf/simulated/floor/plating/airless,
/area/space_structures/cloning_lab)
"bz" = (
/obj/structure/table/glass,
/obj/item/weapon/folder/white,
/obj/item/clothing/accessory/stethoscope,
/obj/machinery/atmospherics/components/unary/vent_pump/on{
	dir = 1
	},
/turf/simulated/floor{
	icon_state = "white"
	},
/area/space_structures/cloning_lab)
"cj" = (
/turf/environment/space,
/area/space)
"dd" = (
/obj/structure/disposalpipe/segment{
	dir = 4
	},
/obj/machinery/atmospherics/pipe/simple/hidden/scrubbers{
	dir = 4
	},
/obj/machinery/atmospherics/pipe/manifold/hidden/supply{
	dir = 1
	},
/turf/simulated/floor{
	icon_state = "white"
	},
/area/space_structures/cloning_lab)
"dj" = (
/obj/structure/drain,
/obj/machinery/shower{
	dir = 4
	},
/obj/effect/decal/cleanable/dirt,
/turf/simulated/floor{
	icon_state = "freezerfloor2"
	},
/area/space_structures/cloning_lab)
"eD" = (
/obj/structure/stool/bed,
/obj/item/weapon/bedsheet/medical,
/obj/machinery/atmospherics/components/unary/vent_scrubber/on,
/turf/simulated/floor{
	icon_state = "white"
	},
/area/space_structures/cloning_lab)
"fd" = (
/obj/item/trash/chinese4,
/turf/environment/space,
/area/space)
"fZ" = (
/obj/structure/closet/secure_closet/personal/patient,
/turf/simulated/floor{
	icon_state = "white"
	},
/area/space_structures/cloning_lab)
"gT" = (
/obj/structure/drain{
	drainage = 2
	},
/turf/simulated/floor{
	dir = 5;
	icon_state = "vault"
	},
/area/space_structures/cloning_lab)
"ib" = (
/obj/structure/closet/l3closet/general,
/obj/item/clothing/mask/gas/coloured,
/obj/effect/decal/remains/human,
/obj/item/clothing/suit/storage/labcoat/genetics,
/obj/item/weapon/paper/cloning_lab,
/turf/environment/space,
/area/space)
"jm" = (
/obj/effect/decal/cleanable/dirt,
/turf/simulated/floor{
	dir = 1;
	icon_state = "whiteblue"
	},
/area/space_structures/cloning_lab)
"jn" = (
/obj/machinery/door/airlock/research{
	name = "Research Division Access"
	},
/obj/structure/disposalpipe/segment{
	dir = 4
	},
/obj/machinery/atmospherics/pipe/simple/hidden/scrubbers{
	dir = 4
	},
/obj/machinery/atmospherics/pipe/simple/hidden/supply{
	dir = 4
	},
/obj/structure/cable{
	d1 = 4;
	d2 = 8;
	icon_state = "4-8"
	},
/turf/simulated/floor{
	dir = 5;
	icon_state = "vault"
	},
/area/space_structures/cloning_lab)
"jv" = (
/obj/structure/disposalpipe/segment{
	dir = 4
	},
/obj/machinery/atmospherics/pipe/simple/hidden/scrubbers{
	dir = 4
	},
/obj/machinery/atmospherics/pipe/simple/hidden/supply{
	dir = 4
	},
/obj/structure/cable{
	d1 = 1;
	d2 = 4;
	icon_state = "1-4"
	},
/turf/simulated/floor{
	dir = 4;
	icon_state = "whiteblue"
	},
/area/space_structures/cloning_lab)
"lv" = (
/obj/machinery/computer/cloning{
	dir = 4
	},
/obj/structure/window/reinforced{
	dir = 1
	},
/turf/simulated/floor{
	dir = 9;
	icon_state = "whiteblue"
	},
/area/space_structures/cloning_lab)
"ow" = (
/obj/structure/grille,
/obj/machinery/door/firedoor,
/obj/structure/window/reinforced{
	dir = 5
	},
/turf/simulated/floor/plating,
/area/space_structures/cloning_lab)
"oY" = (
/obj/structure/window/reinforced,
/obj/machinery/disposal,
/obj/structure/disposalpipe/trunk{
	dir = 1
	},
/turf/simulated/floor{
	dir = 10;
	icon_state = "whiteblue"
	},
/area/space_structures/cloning_lab)
"qh" = (
/obj/machinery/shower{
	pixel_y = 24
	},
/obj/effect/decal/cleanable/dirt,
/turf/simulated/floor{
	dir = 5;
	icon_state = "vault"
	},
/area/space_structures/cloning_lab)
"rX" = (
/obj/structure/disposalpipe/segment{
	dir = 4
	},
/obj/machinery/atmospherics/pipe/simple/hidden/scrubbers{
	dir = 4
	},
/obj/machinery/atmospherics/pipe/simple/hidden/supply{
	dir = 4
	},
/obj/effect/decal/cleanable/dirt,
/turf/simulated/floor{
	icon_state = "white"
	},
/area/space_structures/cloning_lab)
"sn" = (
/obj/structure/flora/ausbushes/ppflowers,
/obj/effect/decal/remains/human,
/obj/effect/decal/cleanable/dirt,
/turf/simulated/floor/grass,
/area/space_structures/cloning_lab)
"tk" = (
/obj/structure/table/glass,
/obj/structure/window/reinforced,
/obj/item/weapon/storage/pill_bottle/dylovene,
/obj/item/weapon/reagent_containers/glass/bottle/antitoxin,
/obj/item/weapon/reagent_containers/syringe,
/turf/simulated/floor{
	dir = 6;
	icon_state = "whiteblue"
	},
/area/space_structures/cloning_lab)
"uM" = (
/obj/structure/window/reinforced,
/obj/machinery/atmospherics/components/unary/vent_pump/on{
	dir = 1
	},
/obj/effect/decal/cleanable/dirt,
/turf/simulated/floor{
	icon_state = "whiteblue"
	},
/area/space_structures/cloning_lab)
"uN" = (
/obj/structure/window/reinforced,
/obj/structure/window/reinforced{
	dir = 4
	},
/obj/effect/decal/cleanable/dirt,
/turf/simulated/floor{
	dir = 5;
	icon_state = "vault"
	},
/area/space_structures/cloning_lab)
"uZ" = (
/obj/structure/disposalpipe/segment{
	dir = 4;
	icon_state = "pipe-c"
	},
/obj/machinery/atmospherics/pipe/simple/hidden/scrubbers{
	dir = 4
	},
/obj/machinery/atmospherics/pipe/simple/hidden/supply{
	dir = 4
	},
/obj/item/weapon/shard,
/obj/effect/decal/cleanable/dirt,
/turf/simulated/floor{
	dir = 9;
	icon_state = "whiteblue"
	},
/area/space_structures/cloning_lab)
"wr" = (
/obj/structure/disposalpipe/segment{
	dir = 4
	},
/obj/machinery/atmospherics/pipe/manifold/hidden/scrubbers{
	dir = 1
	},
/obj/machinery/atmospherics/pipe/simple/hidden/supply{
	dir = 4
	},
/turf/simulated/floor{
	dir = 1;
	icon_state = "whiteblue"
	},
/area/space_structures/cloning_lab)
"xj" = (
/obj/structure/stool/bed/chair/metal/white{
	dir = 4
	},
/obj/effect/decal/cleanable/dirt,
/turf/simulated/floor{
	icon_state = "white"
	},
/area/space_structures/cloning_lab)
"xY" = (
/obj/structure/lattice,
/turf/environment/space,
/area/space)
"xZ" = (
/obj/machinery/computer/scan_consolenew,
/turf/simulated/floor{
	icon_state = "whitebluefull"
	},
/area/space_structures/cloning_lab)
"yz" = (
/obj/structure/table/glass,
/obj/item/weapon/paper_bin,
/obj/item/weapon/pen,
/obj/item/weapon/disk/research_points/rare{
	pixel_x = 6;
	pixel_y = 7
	},
/turf/simulated/floor{
	icon_state = "whitebluefull"
	},
/area/space_structures/cloning_lab)
"AZ" = (
/obj/structure/grille,
/turf/environment/space,
/area/space)
"Cu" = (
/obj/structure/disposalpipe/broken{
	dir = 8
	},
/obj/machinery/atmospherics/pipe/cap/hidden/scrubbers{
	dir = 8;
	icon_state = "cap-scrubbers"
	},
/turf/simulated/floor/plating/airless,
/area/space_structures/cloning_lab)
"CB" = (
/turf/simulated/floor{
	icon_state = "white"
	},
/area/space_structures/cloning_lab)
"CD" = (
/obj/structure/cable{
	d2 = 2;
	icon_state = "0-2"
	},
/obj/machinery/power/apc{
	dir = 4;
	name = "Genetics APC";
	pixel_x = 26
	},
/turf/simulated/floor{
	dir = 5;
	icon_state = "whiteblue"
	},
/area/space_structures/cloning_lab)
"CZ" = (
/obj/item/stack/rods,
/turf/environment/space,
/area/space)
"EF" = (
/obj/item/trash/pistachios,
/turf/simulated/floor/plating/airless,
/area/space_structures/cloning_lab)
"FJ" = (
/obj/structure/flora/ausbushes/ppflowers,
/turf/simulated/floor/grass,
/area/space_structures/cloning_lab)
"GW" = (
/obj/machinery/clonepod,
/obj/structure/window/reinforced{
	dir = 4
	},
/turf/simulated/floor{
	dir = 5;
	icon_state = "vault"
	},
/area/space_structures/cloning_lab)
"HE" = (
/obj/machinery/dna_scannernew,
/turf/simulated/floor{
	icon_state = "whitebluefull"
	},
/area/space_structures/cloning_lab)
"HY" = (
/obj/item/stack/cable_coil/red,
/turf/environment/space,
/area/space)
"Ix" = (
/obj/structure/flora/ausbushes/sparsegrass,
/turf/simulated/floor/grass,
/area/space_structures/cloning_lab)
"IA" = (
/obj/structure/flora/ausbushes/ywflowers,
/obj/effect/decal/cleanable/dirt,
/turf/simulated/floor/grass,
/area/space_structures/cloning_lab)
"Kh" = (
/obj/machinery/door/airlock/medical{
	name = "Patient Room 1"
	},
/obj/machinery/atmospherics/pipe/simple/hidden/scrubbers{
	dir = 4
	},
/obj/machinery/atmospherics/pipe/simple/hidden/supply{
	dir = 4
	},
/turf/simulated/floor{
	icon_state = "white"
	},
/area/space_structures/cloning_lab)
"Kw" = (
/turf/simulated/floor{
	dir = 10;
	icon_state = "warnwhite"
	},
/area/space_structures/cloning_lab)
"Ng" = (
/obj/structure/grille{
	destroyed = 1
	},
/turf/environment/space,
/area/space)
"NI" = (
/obj/effect/decal/cleanable/dirt,
/turf/simulated/floor/plating/airless,
/area/space_structures/cloning_lab)
"Ok" = (
/obj/item/weapon/shard{
	icon_state = "small"
	},
/obj/effect/decal/cleanable/dirt,
/turf/simulated/floor{
	icon_state = "whiteblue"
	},
/area/space_structures/cloning_lab)
"Pd" = (
/turf/simulated/floor/grass,
/area/space_structures/cloning_lab)
"Qq" = (
/obj/structure/lattice,
/obj/item/weapon/shard{
	icon_state = "small"
	},
/turf/environment/space,
/area/space)
"QT" = (
/obj/structure/closet/l3closet/general,
/obj/item/clothing/mask/gas/coloured,
/turf/simulated/floor{
	dir = 9;
	icon_state = "warnwhite"
	},
/area/space_structures/cloning_lab)
"QW" = (
/obj/structure/window/reinforced,
/obj/machinery/atmospherics/components/unary/vent_scrubber/on{
	dir = 1
	},
/turf/simulated/floor{
	icon_state = "whiteblue"
	},
/area/space_structures/cloning_lab)
"SD" = (
/turf/simulated/wall/r_wall,
/area/space_structures/cloning_lab)
"SE" = (
/obj/effect/decal/cleanable/dirt,
/turf/simulated/floor/grass,
/area/space_structures/cloning_lab)
"Tg" = (
/obj/structure/disposalpipe/segment{
	dir = 4
	},
/obj/machinery/atmospherics/pipe/simple/hidden/scrubbers{
	dir = 4
	},
/obj/machinery/atmospherics/pipe/simple/hidden/supply{
	dir = 4
	},
/obj/structure/cable{
	d1 = 4;
	d2 = 8;
	icon_state = "4-8"
	},
/obj/effect/decal/cleanable/dirt,
/turf/simulated/floor{
	dir = 10;
	icon_state = "warnwhite"
	},
/area/space_structures/cloning_lab)
"Tz" = (
/turf/simulated/floor{
	dir = 5;
	icon_state = "vault"
	},
/area/space_structures/cloning_lab)
"Vj" = (
/obj/structure/disposalpipe/segment{
	dir = 4
	},
/obj/machinery/atmospherics/pipe/simple/hidden/scrubbers{
	dir = 4
	},
/obj/machinery/atmospherics/pipe/simple/hidden/supply{
	dir = 4
	},
/obj/structure/cable{
	d1 = 4;
	d2 = 8;
	icon_state = "4-8"
	},
/turf/simulated/floor{
	icon_state = "warnwhite"
	},
/area/space_structures/cloning_lab)
"VN" = (
/obj/structure/disposalpipe/segment{
	dir = 4
	},
/obj/machinery/atmospherics/pipe/simple/hidden/scrubbers{
	dir = 4
	},
/obj/machinery/atmospherics/pipe/simple/hidden/supply{
	dir = 4
	},
/turf/simulated/floor{
	dir = 1;
	icon_state = "whitebluecorner"
	},
/area/space_structures/cloning_lab)
"VO" = (
/obj/structure/stool/bed/chair/office/light{
	dir = 1
	},
/obj/effect/decal/cleanable/dirt,
/turf/simulated/floor{
	dir = 1;
	icon_state = "whiteblue"
	},
/area/space_structures/cloning_lab)
"VY" = (
/obj/structure/flora/ausbushes/sparsegrass,
/obj/effect/decal/remains/human,
/turf/simulated/floor/grass,
/area/space_structures/cloning_lab)
"WT" = (
/obj/structure/lattice,
/obj/item/weapon/shard{
	icon_state = "medium"
	},
/turf/environment/space,
/area/space)
"WU" = (
/obj/structure/lattice,
/obj/item/stack/sheet/metal,
/turf/environment/space,
/area/space)
"WW" = (
/obj/item/stack/sheet/metal,
/turf/environment/space,
/area/space)
"XK" = (
/obj/machinery/atmospherics/pipe/simple/hidden/scrubbers{
	dir = 5
	},
/obj/machinery/atmospherics/pipe/simple/hidden/supply{
	dir = 6
	},
/obj/effect/decal/cleanable/dirt,
/turf/simulated/floor{
	icon_state = "white"
	},
/area/space_structures/cloning_lab)
"Yx" = (
/obj/structure/table/glass,
/obj/structure/window/reinforced,
/obj/item/device/healthanalyzer,
/obj/item/device/flashlight/pen{
	pixel_x = 4;
	pixel_y = 3
	},
/turf/simulated/floor{
	icon_state = "whiteblue"
	},
/area/space_structures/cloning_lab)
"Zz" = (
/obj/structure/disposalpipe/segment{
	dir = 4
	},
/obj/machinery/atmospherics/pipe/simple/hidden/scrubbers{
	dir = 4
	},
/obj/machinery/atmospherics/pipe/cap/hidden/supply{
	dir = 8;
	icon_state = "cap-supply"
	},
/obj/structure/cable{
	d2 = 8;
	icon_state = "0-8"
	},
/turf/simulated/floor/plating/airless,
/area/space_structures/cloning_lab)

(1,1,1) = {"
cj
cj
AZ
AZ
cj
Ng
AZ
cj
cj
cj
"}
(2,1,1) = {"
AZ
cj
xY
xY
xY
cj
xY
xY
AZ
cj
"}
(3,1,1) = {"
Ng
xY
SD
ow
ow
ow
SD
xY
AZ
cj
"}
(4,1,1) = {"
cj
xY
ow
fZ
CB
xj
ow
xY
xY
cj
"}
(5,1,1) = {"
AZ
xY
ow
eD
XK
bz
ow
xY
xY
Ng
"}
(6,1,1) = {"
cj
SD
SD
SD
Kh
SD
SD
SD
cj
AZ
"}
(7,1,1) = {"
cj
SD
qh
gT
uZ
oY
VY
SD
SD
cj
"}
(8,1,1) = {"
xY
SD
Tz
uN
wr
QW
FJ
Ix
ow
cj
"}
(9,1,1) = {"
xY
SD
GW
lv
VN
Ok
SE
IA
ow
cj
"}
(10,1,1) = {"
cj
ow
HE
jm
dd
uM
Pd
Ix
ow
cj
"}
(11,1,1) = {"
cj
ow
xZ
VO
rX
Yx
SE
sn
ow
cj
"}
(12,1,1) = {"
xY
ow
yz
CD
jv
tk
VY
SD
SD
xY
"}
(13,1,1) = {"
xY
SD
SD
SD
jn
SD
SD
SD
xY
Ng
"}
(14,1,1) = {"
cj
xY
SD
QT
Tg
dj
SD
xY
cj
AZ
"}
(15,1,1) = {"
cj
CZ
SD
NI
Vj
NI
SD
xY
xY
xY
"}
(16,1,1) = {"
WW
cj
WT
bt
Zz
Kw
SD
xY
cj
cj
"}
(17,1,1) = {"
cj
ib
cj
xY
Cu
NI
SD
cj
cj
cj
"}
(18,1,1) = {"
cj
xY
cj
HY
xY
EF
xY
CZ
cj
cj
"}
(19,1,1) = {"
cj
cj
cj
fd
WU
xY
cj
cj
cj
cj
"}
(20,1,1) = {"
cj
cj
cj
CZ
cj
Qq
cj
cj
cj
cj
"}
