//MAP CONVERTED BY dmm2tgm.py THIS HEADER COMMENT PREVENTS RECONVERSION, DO NOT REMOVE
"ab" = (
/turf/simulated/mineral,
/turf/environment/space,
/area/space)
"ac" = (
/turf/simulated/shuttle/floor{
	icon_state = "floor2"
	},
/area/space)
"bo" = (
/turf/simulated/floor/airless{
	icon_state = "wood"
	},
/area/space)
"bu" = (
/obj/item/weapon/bananapeel,
/turf/simulated/floor/airless{
	icon_state = "wood"
	},
/area/space)
"cN" = (
/obj/machinery/door/airlock/clown/glass,
/turf/simulated/shuttle/floor{
	icon_state = "floor2"
	},
/area/space)
"di" = (
/obj/item/weapon/shard{
	icon_state = "small"
	},
/obj/effect/decal/cleanable/blood/drip,
/turf/simulated/floor/plating/airless/asteroid,
/area/space)
"fe" = (
/turf/environment/space,
/area/space)
"gL" = (
/obj/machinery/mining/brace,
/turf/simulated/floor/airless{
	icon_state = "wood"
	},
/area/space)
"gS" = (
/obj/structure/closet/theatrecloset,
/obj/random/randomtoy,
/obj/structure/mirror{
	pixel_y = 26
	},
/obj/item/weapon/reagent_containers/food/snacks/grown/banana/honk,
/turf/simulated/floor/airless{
	icon_state = "wood"
	},
/area/space)
"iN" = (
/obj/effect/landmark/corpse/clown{
	name = "Clown Pilot"
	},
/turf/simulated/floor/airless{
	icon_state = "wood"
	},
/area/space)
"kY" = (
/obj/item/weapon/shard,
/obj/effect/decal/cleanable/blood,
/obj/effect/decal/cleanable/dirt,
/turf/simulated/floor/airless{
	icon_state = "wood"
	},
/area/space)
"kZ" = (
/obj/item/weapon/shard{
	icon_state = "medium"
	},
/turf/simulated/floor/plating/airless/asteroid,
/area/space)
"lb" = (
/obj/effect/decal/cleanable/blood,
/obj/item/weapon/reagent_containers/food/snacks/grown/banana,
/turf/simulated/floor/airless{
	icon_state = "wood"
	},
/area/space)
"mX" = (
/obj/structure/window/reinforced{
	dir = 8
	},
/obj/structure/shuttle/engine/heater{
	dir = 4;
	icon_state = "heater1"
	},
/turf/simulated/floor/plating/airless,
/area/space)
"nm" = (
/obj/item/weapon/bananapeel,
/obj/machinery/door/airlock/clown/glass{
	state_open = 1
	},
/turf/simulated/shuttle/floor{
	icon_state = "floor2"
	},
/area/space)
"nD" = (
/obj/structure/closet/crate,
/obj/item/weapon/ore/clown,
/obj/item/weapon/ore/clown,
/obj/item/weapon/ore/clown,
/obj/item/weapon/ore/clown,
/obj/item/weapon/ore/clown,
/obj/item/weapon/ore/clown,
/obj/item/weapon/mining_scanner,
/obj/structure/sign/poster/contraband/clown{
	pixel_y = -32
	},
/turf/simulated/floor/airless{
	icon_state = "wood"
	},
/area/space)
"nT" = (
/obj/machinery/computer/arcade,
/obj/structure/sign/poster/contraband/clown{
	pixel_y = 32
	},
/turf/simulated/floor/airless{
	icon_state = "wood"
	},
/area/space)
"qF" = (
/obj/random/randomfigure,
/turf/simulated/floor/airless{
	icon_state = "wood"
	},
/area/space)
"tF" = (
/obj/machinery/mining/drill,
/turf/simulated/floor/airless{
	icon_state = "wood"
	},
/area/space)
"wc" = (
/obj/item/weapon/ore/clown,
/obj/effect/decal/cleanable/dirt,
/turf/simulated/floor/plating/airless{
	icon_state = "grimy"
	},
/area/space)
"wE" = (
/obj/item/clothing/head/helmet/space/clown,
/turf/simulated/floor/plating/airless{
	icon_state = "grimy"
	},
/area/space)
"xk" = (
/obj/item/weapon/ore/clown,
/turf/simulated/floor/plating/airless{
	icon_state = "grimy"
	},
/area/space)
"yG" = (
/obj/structure/grille,
/obj/structure/window/reinforced,
/obj/structure/window/reinforced{
	dir = 8
	},
/obj/structure/window/reinforced{
	dir = 4
	},
/turf/simulated/floor/plating/airless,
/area/space)
"yZ" = (
/obj/structure/closet/crate,
/obj/item/weapon/ore/clown,
/obj/item/weapon/ore/clown,
/obj/item/weapon/ore/clown,
/obj/item/weapon/ore/clown,
/obj/item/weapon/ore/clown,
/obj/item/weapon/ore/clown,
/obj/item/weapon/ore/clown,
/obj/item/weapon/ore/clown,
/obj/random/randomtoy,
/obj/effect/decal/cleanable/dirt,
/turf/simulated/floor/airless{
	icon_state = "wood"
	},
/area/space)
"zz" = (
/obj/effect/decal/cleanable/blood/drip,
/obj/item/weapon/ore/clown,
/obj/effect/decal/cleanable/dirt,
/turf/simulated/floor/airless{
	icon_state = "wood"
	},
/area/space)
"zM" = (
/obj/item/weapon/ore/clown,
/obj/effect/decal/cleanable/blood/drip,
/obj/effect/decal/cleanable/dirt,
/obj/item/weapon/bananapeel,
/turf/simulated/floor/plating/airless{
	icon_state = "grimy"
	},
/area/space)
"Bu" = (
/obj/structure/closet/crate/freezer,
/obj/item/weapon/reagent_containers/food/snacks/breadslice/banana,
/obj/item/weapon/reagent_containers/food/snacks/breadslice/banana,
/obj/item/weapon/reagent_containers/food/snacks/sliceable/bread/banana,
/obj/item/weapon/reagent_containers/food/snacks/friedbanana,
/obj/item/weapon/reagent_containers/food/snacks/friedbanana,
/obj/item/weapon/reagent_containers/food/snacks/clownburger,
/obj/random/foods/donuts,
/obj/random/foods/donuts,
/obj/random/foods/donuts,
/turf/simulated/floor/plating/airless/asteroid,
/area/space)
"Cc" = (
/obj/structure/ore_box,
/turf/simulated/floor/airless{
	icon_state = "wood"
	},
/area/space)
"Cz" = (
/obj/item/weapon/reagent_containers/food/snacks/grown/banana,
/obj/effect/decal/cleanable/dirt,
/turf/simulated/floor/plating/airless/asteroid,
/area/space)
"En" = (
/turf/environment/space,
/turf/simulated/wall/mineral/bananium,
/area/space)
"FG" = (
/obj/machinery/vending/theater,
/turf/simulated/floor/airless{
	icon_state = "wood"
	},
/area/space)
"FQ" = (
/obj/structure/shuttle/engine/propulsion{
	anchored = 0;
	dir = 4;
	icon_state = "burst_l"
	},
/turf/environment/space,
/area/space)
"HA" = (
/obj/structure/closet/crate,
/obj/item/weapon/ore/clown,
/obj/item/weapon/ore/clown,
/obj/item/weapon/ore/clown,
/obj/item/weapon/ore/clown,
/obj/item/weapon/ore/clown,
/obj/item/weapon/ore/clown,
/obj/item/weapon/ore/clown,
/obj/item/weapon/wrench,
/turf/simulated/floor/airless{
	icon_state = "wood"
	},
/area/space)
"HQ" = (
/obj/item/weapon/ore/clown,
/obj/effect/decal/cleanable/blood,
/obj/effect/decal/cleanable/dirt,
/turf/simulated/floor/plating/airless{
	icon_state = "grimy"
	},
/area/space)
"HY" = (
/turf/simulated/wall/mineral/bananium,
/area/space)
"IU" = (
/turf/simulated/floor/plating/airless/asteroid,
/area/space)
"Kd" = (
/obj/item/device/guitar/electric,
/turf/simulated/floor/plating/airless{
	icon_state = "grimy"
	},
/area/space)
"KM" = (
/obj/item/weapon/paper{
	info = "The call has gone out! Our ancestral home has been rediscovered! Not a small patch of land, but a true clown nation, a true Clown Planet! We're on our way home at last!"
	},
/obj/effect/decal/cleanable/dirt,
/turf/simulated/floor/airless{
	icon_state = "wood"
	},
/area/space)
"LE" = (
/obj/item/weapon/ore/clown,
/obj/effect/decal/cleanable/dirt,
/turf/simulated/floor/airless{
	icon_state = "wood"
	},
/area/space)
"LT" = (
/obj/item/clothing/suit/space/clown,
/turf/simulated/floor/plating/airless/asteroid,
/area/space)
"Mo" = (
/obj/structure/shuttle/engine/propulsion{
	dir = 4
	},
/turf/environment/space,
/area/space)
"Ns" = (
/obj/item/weapon/pickaxe,
/obj/structure/table/woodentable,
/obj/item/weapon/pickaxe{
	pixel_y = 3
	},
/obj/item/weapon/storage/bag/ore{
	pixel_y = -3
	},
/obj/effect/decal/cleanable/dirt,
/turf/simulated/floor/airless{
	icon_state = "wood"
	},
/area/space)
"Nw" = (
/obj/effect/landmark/corpse/clown,
/turf/simulated/floor/plating/airless{
	icon_state = "grimy"
	},
/area/space)
"NA" = (
/turf/simulated/mineral,
/area/space)
"NJ" = (
/obj/structure/closet/crate,
/obj/item/toy/prize/honk,
/obj/item/weapon/coin/bananium,
/obj/item/weapon/coin/bananium{
	pixel_x = -3
	},
/obj/item/weapon/coin/bananium{
	pixel_x = 7;
	pixel_y = 5
	},
/obj/random/randomtoy,
/turf/simulated/floor/airless{
	icon_state = "wood"
	},
/area/space)
"RH" = (
/obj/structure/shuttle/engine/propulsion{
	dir = 4;
	icon_state = "burst_r"
	},
/turf/environment/space,
/area/space)
"Su" = (
/obj/effect/decal/cleanable/blood/drip,
/turf/simulated/floor/airless{
	icon_state = "wood"
	},
/area/space)
"UP" = (
/obj/machinery/mining/brace,
/obj/effect/decal/cleanable/dirt,
/turf/simulated/floor/airless{
	icon_state = "wood"
	},
/area/space)
"Vw" = (
/obj/machinery/cell_charger,
/turf/simulated/floor/plating/airless{
	icon_state = "grimy"
	},
/area/space)
"Ya" = (
/obj/effect/decal/cleanable/blood/drip,
/obj/item/weapon/reagent_containers/food/snacks/grown/banana,
/obj/effect/decal/cleanable/dirt,
/turf/simulated/floor/plating/airless{
	icon_state = "grimy"
	},
/area/space)
"YX" = (
/obj/item/weapon/shard{
	icon_state = "medium"
	},
/obj/effect/decal/cleanable/dirt,
/turf/simulated/floor/airless{
	icon_state = "wood"
	},
/area/space)
"Za" = (
/obj/structure/stool/bed/chair/wood/normal,
/obj/effect/decal/cleanable/dirt,
/turf/simulated/floor/plating/airless/asteroid,
/area/space)
"ZH" = (
/obj/item/weapon/stock_parts/cell,
/turf/simulated/floor/plating/airless{
	icon_state = "grimy"
	},
/area/space)

(1,1,1) = {"
fe
NA
NA
fe
fe
fe
fe
fe
fe
fe
fe
fe
fe
fe
fe
fe
fe
"}
(2,1,1) = {"
NA
NA
NA
NA
NA
fe
fe
fe
fe
fe
fe
NA
NA
fe
fe
fe
fe
"}
(3,1,1) = {"
NA
NA
NA
NA
NA
NA
fe
NA
NA
NA
NA
NA
NA
fe
fe
fe
fe
"}
(4,1,1) = {"
fe
NA
NA
NA
NA
NA
NA
NA
NA
NA
NA
NA
fe
fe
fe
fe
fe
"}
(5,1,1) = {"
fe
fe
NA
NA
NA
NA
NA
NA
NA
NA
NA
NA
NA
NA
NA
NA
fe
"}
(6,1,1) = {"
fe
fe
NA
NA
NA
NA
NA
NA
NA
NA
NA
NA
NA
NA
NA
fe
fe
"}
(7,1,1) = {"
fe
NA
NA
NA
NA
NA
NA
NA
NA
NA
NA
NA
NA
NA
fe
fe
fe
"}
(8,1,1) = {"
IU
NA
NA
NA
NA
NA
NA
NA
NA
NA
NA
NA
NA
NA
fe
fe
fe
"}
(9,1,1) = {"
IU
NA
NA
NA
NA
NA
NA
NA
NA
NA
NA
NA
NA
IU
fe
fe
fe
"}
(10,1,1) = {"
IU
NA
NA
NA
NA
NA
NA
NA
NA
NA
NA
NA
IU
IU
fe
fe
fe
"}
(11,1,1) = {"
IU
NA
NA
NA
NA
NA
NA
NA
NA
NA
NA
NA
IU
IU
IU
fe
fe
"}
(12,1,1) = {"
IU
IU
IU
NA
NA
NA
NA
NA
NA
NA
NA
NA
NA
NA
IU
IU
fe
"}
(13,1,1) = {"
IU
IU
IU
NA
NA
NA
NA
NA
NA
NA
NA
NA
NA
NA
NA
NA
fe
"}
(14,1,1) = {"
fe
NA
NA
NA
IU
NA
NA
NA
NA
NA
NA
NA
NA
NA
IU
NA
fe
"}
(15,1,1) = {"
fe
NA
NA
NA
IU
IU
NA
NA
NA
NA
NA
NA
NA
NA
NA
NA
NA
"}
(16,1,1) = {"
fe
NA
fe
fe
fe
HY
NA
NA
yG
ab
NA
NA
NA
NA
NA
NA
NA
"}
(17,1,1) = {"
fe
fe
fe
fe
fe
HY
NA
NA
Cz
NA
NA
NA
NA
NA
IU
NA
NA
"}
(18,1,1) = {"
fe
fe
fe
fe
HY
En
NA
kZ
kY
En
NA
NA
NA
NA
IU
NA
NA
"}
(19,1,1) = {"
fe
fe
fe
fe
HY
Bu
di
iN
LT
NJ
HY
NA
NA
NA
IU
IU
IU
"}
(20,1,1) = {"
fe
fe
fe
fe
HY
Za
LE
qF
YX
Ns
HY
NA
NA
NA
fe
fe
fe
"}
(21,1,1) = {"
fe
fe
fe
fe
nm
LE
lb
KM
bo
zz
ac
NA
NA
fe
fe
fe
fe
"}
(22,1,1) = {"
fe
fe
fe
fe
cN
Su
Kd
wc
Nw
bu
cN
NA
NA
fe
fe
fe
fe
"}
(23,1,1) = {"
fe
fe
fe
fe
HY
nT
Nw
Vw
Ya
nD
HY
NA
fe
fe
fe
fe
fe
"}
(24,1,1) = {"
fe
fe
fe
fe
HY
gS
wE
xk
HQ
yZ
HY
NA
fe
fe
fe
fe
fe
"}
(25,1,1) = {"
fe
fe
fe
fe
HY
FG
zM
wc
ZH
HA
HY
NA
fe
fe
fe
fe
fe
"}
(26,1,1) = {"
fe
fe
fe
fe
HY
tF
gL
UP
qF
Cc
HY
fe
fe
fe
fe
fe
fe
"}
(27,1,1) = {"
fe
fe
fe
fe
HY
mX
mX
mX
mX
mX
HY
fe
fe
fe
fe
fe
fe
"}
(28,1,1) = {"
fe
fe
fe
fe
fe
RH
Mo
Mo
Mo
FQ
fe
fe
fe
fe
fe
fe
fe
"}
