//MAP CONVERTED BY dmm2tgm.py THIS HEADER COMMENT PREVENTS RECONVERSION, DO NOT REMOVE
"a" = (
/turf/environment/space,
/area/space)
"b" = (
/obj/effect/decal/cleanable/toilet_paint,
/turf/simulated/wall,
/area/space)
"c" = (
/turf/simulated/wall,
/area/space)
"d" = (
/obj/structure/window/reinforced{
	dir = 4
	},
/turf/simulated/floor/plating/airless,
/area/space)
"e" = (
/obj/structure/toilet{
	pixel_y = 8
	},
/obj/effect/decal/cleanable/cobweb,
/turf/simulated/floor/plating/airless,
/area/space)
"f" = (
/obj/structure/stool,
/obj/effect/decal/remains/human,
/turf/simulated/floor/plating/airless,
/area/space)
"g" = (
/obj/structure/window/reinforced{
	dir = 8
	},
/turf/simulated/floor/plating/airless,
/area/space)
"k" = (
/obj/machinery/door/window/southright,
/obj/item/weapon/disk/research_points,
/turf/simulated/floor/plating/airless,
/area/space)
"l" = (
/turf/simulated/floor/plating/airless,
/area/space)

(1,1,1) = {"
c
d
d
l
a
"}
(2,1,1) = {"
b
e
k
l
l
"}
(3,1,1) = {"
c
g
g
f
a
"}
